1 1 1 1 1
2 0 5 0 3
2 0 4 0 3
2 0 0 0 3
2 3 0 0 3
4 4 4 4 4
